000111101011110
000000011110100
011010110000001
000010111110000
000010010100100
010001100001101
000011110101100
001100000111111
001000001100011
001010001000100
001100100100110
001001001100000
010011000000100
010100000111110
000011110111000